tileswide 25
tileshigh 20
tilewidth 32
tileheight 32

layer 0
17,13,13,13,13,13,13,13,13,13,13,13,13,13,13,13,13,13,13,13,18,21,21,21,21,
11,8,8,8,8,8,8,8,8,8,8,8,8,8,8,8,8,8,8,8,14,13,18,21,21,
11,8,8,8,8,8,8,8,8,8,8,8,8,8,8,8,8,8,8,8,8,8,22,21,21,
11,20,1,1,1,1,1,1,1,1,1,1,1,1,8,8,8,8,8,8,8,8,22,21,21,
11,7,0,0,0,0,0,0,0,0,0,0,0,0,8,8,8,8,8,8,8,8,22,21,21,
11,7,0,0,0,0,0,0,0,0,0,0,0,0,8,8,8,8,8,8,8,8,22,21,21,
11,7,0,0,0,0,0,5,5,5,5,5,5,5,8,8,8,8,8,8,8,8,22,21,21,
11,7,0,0,0,0,0,3,15,9,9,9,10,8,8,8,8,8,8,8,8,8,22,21,21,
11,7,0,0,0,0,3,15,19,21,21,21,11,8,8,8,8,8,8,8,8,8,22,21,21,
11,7,0,0,0,0,3,22,21,21,21,21,16,9,9,9,10,8,8,8,8,8,22,21,21,
11,7,0,0,0,0,3,14,13,13,13,13,13,13,13,18,16,9,9,9,9,9,19,21,21,
11,7,0,0,0,0,3,8,8,8,8,8,8,8,8,14,18,21,21,21,21,21,21,21,21,
11,6,5,5,5,5,4,8,8,8,8,8,8,8,8,8,22,21,21,21,21,21,17,13,13,
16,9,9,9,10,8,8,15,9,9,10,8,8,8,8,8,14,13,13,13,13,13,12,8,8,
21,21,21,21,11,8,8,22,21,21,16,9,10,8,8,8,8,8,20,1,1,1,1,1,1,
21,21,21,21,11,8,8,22,21,17,13,13,12,8,8,15,10,8,7,0,0,0,0,0,0,
21,21,21,21,11,8,8,22,21,11,8,8,8,8,8,14,12,8,7,0,0,0,0,0,0,
21,21,21,21,11,8,8,14,13,12,8,8,8,8,8,8,8,7,0,0,0,0,0,0,0,
21,21,21,21,11,20,1,1,1,1,1,1,1,1,0,0,0,0,0,0,0,0,0,0,0,
21,21,21,21,11,7,0,0,0,0,0,0,0,0,0,0,0,0,0,0,0,0,0,0,0,

