17,13,13,13,13,13,13,13,13,13,13,13,13,13,13,13,13,13,13,13,18,21,21,21,21
11,08,08,08,08,08,08,08,08,08,08,08,08,08,08,08,08,08,08,08,14,13,18,21,21
11,08,08,08,08,08,08,08,08,08,08,08,08,08,08,08,08,08,08,08,08,08,22,21,21
11,20,01,01,01,01,01,01,01,01,01,01,01,01,08,08,08,08,08,08,08,08,22,21,21
11,07,00,00,00,00,00,00,00,00,00,00,00,00,08,08,08,08,08,08,08,08,22,21,21
11,07,00,00,00,00,00,00,00,00,00,00,00,00,08,08,08,08,08,08,08,08,22,21,21
11,07,00,00,00,00,00,05,05,05,05,05,05,05,08,08,08,08,08,08,08,08,22,21,21
11,07,00,00,00,00,00,03,15,09,09,09,10,08,08,08,08,08,08,08,08,08,22,21,21
11,07,00,00,00,00,03,15,19,21,21,21,11,08,08,08,08,08,08,08,08,08,22,21,21
11,07,00,00,00,00,03,22,21,21,21,21,16,09,09,09,10,08,08,08,08,08,22,21,21
11,07,00,00,00,00,03,14,13,13,13,13,13,13,13,18,16,09,09,09,09,09,19,21,21
11,07,00,00,00,00,03,08,08,08,08,08,08,08,08,14,18,21,21,21,21,21,21,21,21
11,06,05,05,05,05,04,08,08,08,08,08,08,08,08,08,22,21,21,21,21,21,17,13,13
16,09,09,09,10,08,08,15,09,09,10,08,08,08,08,08,14,13,13,13,13,13,12,08,08
21,21,21,21,11,08,08,22,21,21,16,09,10,08,08,08,08,08,20,01,01,01,01,01,01
21,21,21,21,11,08,08,22,21,17,13,13,12,08,08,15,10,08,07,00,00,00,00,00,00
21,21,21,21,11,08,08,22,21,11,08,08,08,08,08,14,12,08,07,00,00,00,00,00,00
21,21,21,21,11,08,08,14,13,12,08,08,08,08,08,08,08,07,00,00,00,00,00,00,00
21,21,21,21,11,20,01,01,01,01,01,01,01,01,00,00,00,00,00,00,00,00,00,00,00
21,21,21,21,11,07,00,00,00,00,00,00,00,00,00,00,00,00,00,00,00,00,00,00,00

1,1,1,1,1,1,1,1,1,1,1,1,1,1,1,1,1,1,1,1,1,0,0,0,0
1,0,0,0,0,0,0,0,0,0,0,0,0,0,0,0,0,0,0,0,1,1,1,0,0
1,0,0,0,0,0,0,0,0,0,0,0,0,0,0,0,0,0,0,0,0,0,1,0,0
1,0,0,0,0,0,0,0,0,0,0,0,0,0,0,0,0,0,0,0,0,0,1,0,0
1,0,0,0,0,0,0,0,0,0,0,0,0,0,0,0,0,0,0,0,0,0,1,0,0
1,0,0,0,0,0,0,0,0,0,0,0,0,0,0,0,0,0,0,0,0,0,1,0,0
1,0,0,0,0,0,0,0,0,0,0,0,0,0,0,0,0,0,0,0,0,0,1,0,0
1,0,0,0,0,0,0,0,1,1,1,1,1,0,0,0,0,0,0,0,0,0,1,0,0
1,0,0,0,0,0,0,1,1,0,0,0,1,0,0,0,0,0,0,0,0,0,1,0,0
1,0,0,0,0,0,0,1,0,0,0,0,1,1,1,1,1,0,0,0,0,0,1,0,0
1,0,0,0,0,0,0,1,1,1,1,1,1,1,1,1,0,1,1,1,1,1,1,0,0
1,0,0,0,0,0,0,0,0,0,0,0,0,0,0,1,1,0,0,0,0,0,0,0,0
1,0,0,0,0,0,0,0,0,0,0,0,0,0,0,0,1,0,0,0,0,0,1,1,1
1,1,1,1,1,0,0,1,1,1,1,0,0,0,0,0,1,1,1,1,1,1,1,0,1
0,0,0,0,1,0,0,1,0,0,1,1,1,0,0,0,0,0,0,0,0,0,0,0,1
0,0,0,0,1,0,0,1,0,1,1,1,1,0,0,1,1,0,0,0,0,0,0,0,1
0,0,0,0,1,0,0,1,0,1,0,0,0,0,0,1,1,0,0,0,0,0,0,0,1
0,0,0,0,1,0,0,1,1,1,0,0,0,0,0,0,0,0,0,0,0,0,0,0,1
0,0,0,0,1,0,0,0,0,0,0,0,0,0,0,0,0,0,0,0,0,0,0,0,1
0,0,0,0,1,1,1,1,1,1,1,1,1,1,1,1,1,1,1,1,1,1,1,1,1

